11111111111111111111111111111111111111111111111111111111111
10010000000C0000000000C0000000000C0000000000C0000000000C111
10P00111110000000000000000000000000000000000000000000000001
100011E0000000000000000000000000000000000000000000000000001
11111111111111111111111111111111111111111111111111111111111
