11111111111111111
1P000000000000EC1
100000000000000C1
100000000000000C1
100000000000000C1
11111111111111111
