11111111111111111111111111111111111111
1P000C000000CC0000E00000000C00000C00C1
11111111111111111111111111111111111111
