1111111111111111111111111111111111111111111111111111111111111
111111111111111111111111111111111111111111111111111PK00E000C1
1111111111111111111111111111111111111111111111111111111111111
1111111111111111111111111111111111111111111111111111111111111
1111111111111111111111111111111111111111111111111111111111111
1111111111111111111111111111111111111111111111111111111111111
1111111111111111111111111111111111111111111111111111111111111
111111111111111111111111111111111111111111111111111111111K111
1111111111111111111111111111111111111111111111111111111111111
1111111111111111111111111111111111111111111111111111111111111
1111111111111111111111111111111111111111111111111111111111111
