111111111111111111111111111111111111111111111
1E00000000CC01000C00010000CC0000K00000CC000K1
10111C0K00010001000C000010000K0000100001000C1
1100K000C00010000CC1000K0001000CC000K00CC1001
100100C00C000001000K000100K000C000111K00000C1
1K00001000CC0000K001000CCC0001000C000001000C1
11CC000010001000100K000CK001000010C00C0001001
10111C0K00010001000C000010000K0000100001000C1
100000P00010000C000C000K00000C0K00010000C1001
111111111111111111111111111111111111111111111
