111111111111111111111111111111
1P011111C011C001000C0100001111
110000000001110100100001100011
110111011C000100000011K1C01011
11K0000000K0C00010111001100KC1
1C1K1101111100K0100000101K1111
100000K000C0001101110C0001C001
111001111111000000111110111001
10001100C0000001K0C00000000K01
110100010111110001011110100101
11010111010100K00000000011C1C1
11010000110101111000110K100111
1C0000001001110000111011100C11
11K1011K0000C000101C00001K1111
1C0101011111110110110111101001
111101000100010C000100C1000001
100001000011011110010111011K01
1001100100C100000101K00001C011
1010100001011011000C1111111111
1KC00KC0K100C01C00010C00000011
1110011101110001K0011011110001
1K10111C00100K0110K1101C1CK001
101K00110110010011001000111101
100010KC01E1111000000011K1K111
10C01101110000C01K100K000000C1
111111111111111111111111111111
